date,sha,text,data,bss,total
2022-01-10 22:39:00.301510,c53927869b2ce15345c6c1751164ca6e4aa47c02,81657,1568,22400,105625
2022-01-10 23:03:56.696004,c53927869b2ce15345c6c1751164ca6e4aa47c02,81657,1568,22400,105625
2022-01-10 23:04:44.309131,c53927869b2ce15345c6c1751164ca6e4aa47c02,81657,1568,22400,105625
2022-01-10 23:10:04.748906,3aab209ca2654013356ba96cd1480ec4b0b76010,81657,1568,22400,105625
2022-01-11 09:32:16.986632,b252173284b23744a78d9a599106e75297b9ff81,81657,1568,22448,105673
2022-01-11 14:59:16.261895,e2eed0b46142015e972cfd301d0e514eb0cf131e,81657,1568,22448,105673
2022-01-11 15:03:24.298672,e2eed0b46142015e972cfd301d0e514eb0cf131e,81657,1568,22448,105673
2022-01-31 18:28:47.436516,746f880a405aeca2db6d005fd9fb8e451f3cea34,83141,1696,22448,107285
2022-02-04 13:02:56.187989,6588458690c5cddc9148ae63bde8beef70055d47,83557,1696,22448,107701
2022-02-07 13:10:21.497565,9cd34d1753fd49f374d1a076f6284179f301b338,83557,1696,22448,107701
2022-02-11 13:04:50.531123,6f8fb4934a1693a1661629534ed4b9f62cb50da3,83557,1696,22448,107701
2022-02-14 13:10:36.573550,041371735a655b24c5e9447422e2115a672ab0a6,83573,1696,22448,107717
2022-02-16 13:09:29.771280,9efa395baa7d85db5807202b3420550300d9297d,83573,1696,22448,107717
2022-02-18 13:05:31.023686,c9b21d3a39842c32bb1f075ddbf3599d3c6b5c3f,83573,1696,22448,107717
2022-02-28 13:08:45.304161,1a0287fc5fa81fa6aa1dcfb0c5b2e01f74164393,83573,1696,22448,107717
2022-03-01 13:09:24.718558,f3c22690fc34183e8f1c068ce8a8d98b5b729cc8,83573,1696,22448,107717
2022-03-04 13:07:15.732929,e8df576b38990f852396c0bc91db26ddcccddc3a,85357,1696,22448,109501
2022-03-07 13:12:18.397213,d7f89e4167e69d219725520e56f1123aa095753d,85357,1696,22448,109501
2022-03-08 13:12:14.032618,cd15c14017bcb33d1ed55ee27c5fab63eef74ad6,85357,1696,22448,109501
2022-03-09 13:11:42.347889,63df59cb461fdec28cc4377cf83097217aeb5b2c,85877,1744,22448,110069
2022-03-10 13:12:39.360738,180694427a7c92530083514bdd0a36a9b7a3f24c,85877,1744,22448,110069
2022-03-14 13:11:31.163719,0b6c93a99f4a79ad8c29ac306da1ac8307a3281e,85877,1744,22448,110069
2022-03-15 13:12:17.005930,7cb4b832abdf33490154d8cf7afe0625b133b3e9,85877,1744,22448,110069
2022-03-16 13:12:13.875189,afd41a759acc425654fb71ce697c03656ac11be9,85877,1744,22448,110069
2022-03-17 13:08:07.891376,359c83a84fed0cb164774ff36798e52d2004eec8,85925,1744,22448,110117
2022-03-18 13:12:04.777824,89a783b8d5d6788527f6cba296a5862072a3831a,85925,1744,22448,110117
2022-03-21 13:12:30.543076,ea94f768500540d816a81d93cb1d1c868dbdfadd,85925,1744,22448,110117
2022-03-23 13:13:22.876874,e0d6c42f5c410f8e1a2aba8ddd0f74c664f68a4f,85925,1744,22448,110117
2022-05-26 02:21:37.044418,ca1d69993f612433e9f4f788e494389d9e7378c1,88629,1920,22480,113029
2022-05-26 02:27:44.332608,ca1d69993f612433e9f4f788e494389d9e7378c1,88629,1920,22480,113029
2022-05-26 13:14:45.192989,ca1d69993f612433e9f4f788e494389d9e7378c1,88629,1920,22480,113029
2022-05-27 13:15:25.001568,ca1d69993f612433e9f4f788e494389d9e7378c1,88629,1920,22480,113029
2022-05-28 13:09:48.335406,7d48cbd96c7fc657b5aa0b39a6e9a238b82d2ee7,88629,1920,22480,113029
